1
----------------------------------------
FFFFFFFFFFFFFFFFFFFFFFFFFFFFFFFFFFFFFFFF
----------------------------------------
----------------------------------------
----------------------------------------
-----------S--------------S-------------
----------------------------------------
----------------------------------------
----------------------------------------
----------------------------------------
----------------------------------------
-----------------------RRRR-------------
------------------------RR--------------
----------------------------------------
----------------------------------------
----------------------------------------
----------@@----------------------------
----------@@----------------------------
----------------------------------------
---------------------CCCCCCC------------
----------------------CCCCCC------------
---------------------CCCCCCC------------
----------------------------------------
----------------------------------------
----------------------------------------